wwwwwwwwwwwwwwwwwwwwwwww
w00000000000000000w0000w
w00wwww00000000000w0000w
w00ww0000000000000w0000w
w000w0000000000000w0000w
w0000000000000000000000w
w000wwww000000000000000w
w000000000000ww00ww0000w
w000000000000ww00ww0000w
w0000000000000000000000w
wwww0000000000000000000w
wwww00000000000ww000000w
w00000000000000ww000000w
w00000000000000ww000000w
w00000000000000ww000000w
wwwwwwwwwwwwwwwwwwwwwwww