wwwwwwwwwwwwwwwwwwwwwwww
w000000w0000000000ww000w
w000000w0000000000ww000w
w000000w000000w00000000w
w0000000000000w00000000w
w0000w00000000www000000w
w0000w00000000000000000w
w0000ww0000000000000000w
w00000000000ww000000000w
w00000000000ww000000000w
w0000000000000000000000w
wwwwww000000000000ww000w
w000000000000000000w000w
w0000000000w0000000w000w
w000000000000000000w000w
wwwwwwwwwwwwwwwwwwwwwwww